// dies ist ein Kommentar!
[DIM]
17,17;
[LEVEL]
2,2,0,2,2, 2,0,2, 2, 2,0,2, 2,2,0,2,2;
2,0,0,0,2, 0,0,0, 2, 0,0,0, 2,0,0,0,2;
0,0,0,0,0, 0,0,0, 0, 0,0,0, 0,0,0,0,0;
2,0,0,0,2, 0,0,0, 2, 0,0,0, 2,0,0,0,2;
2,2,0,2,2, 2,0,2, 2, 2,0,2, 2,2,0,2,2;

2,0,0,0,2, 0,0,0, 0, 0,0,0, 2,0,0,0,2;
0,0,0,0,0, 0,0,0, 0, 0,0,0, 0,0,0,0,0;
2,0,0,0,2, 0,0,0, 0, 0,0,0, 2,0,0,0,2;

2,2,0,2,2, 0,0,0, 8, 0,0,0, 2,2,0,2,2;

2,0,0,0,2, 0,0,0, 0, 0,0,0, 2,0,0,0,2;
0,0,0,0,0, 0,0,0, 0, 0,0,0, 0,0,0,0,0;
2,0,0,0,2, 0,0,0, 0, 0,0,0, 2,0,0,0,2;

2,2,0,2,2, 2,0,2, 2, 2,0,2, 2,2,0,2,2;
2,0,0,0,2, 0,0,0, 2, 0,0,0, 2,0,0,0,2;
0,0,0,0,0, 0,0,0, 0, 0,0,0, 0,0,0,0,0;
2,0,0,0,2, 0,0,0, 2, 0,0,0, 2,0,0,0,2;
2,2,0,2,2, 2,0,2, 2, 2,0,2, 2,2,0,2,2;